                          NO  ./ruta_a_la_textura_norte.xpm                

SO ./ruta_a_la_textura_sur.xpm

           

WE ./ruta_a_la_textura_oeste.xpm
EA                   ./ruta_a_la_textura_este.xpm

F    220,  100,   0





C 225   ,     30   ,   0

1111111 1111111111111111111
10000011101100001111000011111111
1010110000011100000000000001
1001000000000000000000011111
111111111011000001110000111111
1000000000110000011101111111111
11110111111111011100000010001
11110111111111011101010010001
1100000011010101110000001000111
100000000000000110000001000111
10000N00000000000110101001000111
110000011101010111110111100111
11110111 1110101 1011110100001
11111111 1111111 1111111111111